10 20
..#...####....####..
#..................#
..######.#.##.....##
..######..#.#####...
...#......#.........
...#..#...#....#.###
...#....#...........
.#......#######..#..
###.##############.#
#..............#....
