45 100
...##......###...#...##........#...#........#..#.......#...###.....##.....#...###.##.##.##......#...
....................#..#.#..#...#..#....##..##....#.#...###.#.##.#....##...#.##......##.##.#.....###
........##.#.....#..##.....#.......#.#..#......#......#..#.............#..#......#.#..#......#......
....#......##..#...........###.....#.#.....#........#.#...#.........#...........#...##..#.#.#.......
.###........#.............#........#....#....#..#...#.....#..##.#..#..#...##.#....#..##.#.....#.....
.....#............##...#..#..#.#...#....#........#........#...#.#...#..#..........#.##.....#...#....
..#....#.#................###.#..#..........#......#...#.#..##...##.......#....#...##..........##...
.#.#......#.###....#.#...#....#.#..##...........#...............#.#.#...#....#.#.#....##.#.#...#....
..#................##..#..#......#.....#..............#.##......##.#....#...........#..####..#.##.#.
.#.......##..##..##.....#........#......#..##....#.........#.##....#...#.............#...#...#....##
.#.##..#.....#....#...........#.......#.......#..#.#.##.#.#.##........#.#.#.#...#.#.#.....###.#.....
#...#.##.............##...##........#.##.#.#.#........#................##..........#..##..........##
........#.#.....##...#.#..##......#...###..#..##.##..##.##.##..#.#..#.......#..#...#...#.....#...#.#
.......#.........#..#....##....#.....###......#.#..#...##.#.....#..##....##..#...........#...###....
.........#.##.#..###.#..........#....##...#..#...#.#..##..##.........#.....#.#..#...#.....#.##...##.
.#.........#.#..............#.#.##.....####.....#.....#.#.......#..###.....#.......#...#.....###..#.
#.......##...#...........####..#....#.#....#.#.###.#....#.......#......#.#....#.....#..#...###.#....
.....##.....#.......#..#.#...##..#...##.#...#....#..#.###.....##.......#....#.........##..........##
.##.....##.....#.#.....##.###.#..#..#..##.......#.#...#.##..##.....#.............#.....##......#..#.
...#...#.#.....##.....##.#..#...#..#.#...#.........#....##...#....................#....###..........
.#.....#..#.##....#.......#...#..##..#..#.....#....##.......#..#.#......#......#.#.#..###...#.......
............#......##.#.#..#.#...##...#..#.#..##......#..#.......#..##............#.#...#.##.#..##..
#..####.#....#..........##....#.#.#..........#.#.......#.....#...#..###..#.....#..#..........#.#..#.
.....##.........#..#..#...#.#........#....#.........#.#.....#...........#..#.#.#........#.#.....#...
#..........#...##...#.......#..#......#.#...#...#...##.#....#..##.#....##.........##...........##.##
.#....##.#.....#.##...###.........##.........##...#....#####..#..###...#..#..#.#.###.#...##........#
.....#..#.##.#.#..#...#..##.###.#....#.#...##.#...####..#................##......##.....#...#.#.....
.#.#..#........#..........#...#....#..#.#......##.....#.#....#.....##....#........#......##....#.#.#
.#..#.........##...###.#.##.#.....#..#....##...#.#...........#....##..##...#..#..#..................
.#####..#..#..#............#...#.#...#..#......#.##..#....#......#.....##.......####.#...###......##
....####..............#.#.#..........#...##.........#.#..##....###.##.###.#.#...#.#......#.....#.#.#
..#.........#..##..##.#...##...........#......#.#....#...#.#..#.........#...#.#.##..........##.#.#..
.#.....##.....###..#.#.##......#.##...#.#......###.#.#.#.....##......#.#...#...#...##.........#...#.
....#.#..........#....#.........#..#..#..#...#........#.#...#.#...#..#...#...#..#.##.......#........
...........#........###...#....#.....#.....##...#..#....##..#...#......#.#.#.#.##...##...........#..
###......##.....#.#.#..#..............###....#...#.........##...........#..#.......##........#.#...#
...#..#.....####.#.#................#.......#...#.......#.##......#...#.....#.....#.##..#....#..#.#.
....#.#..#.....#.........#.#......#.#............#.#......##....#.#.####....#...#.####..#..###.##...
.#.........#...#......#..###...#.#..##.#..#.....#..##....#....#...#.#.#...#.#.....#..#....###......#
......#.#..................#........#.......#...#....##..#.......##..#.....###.....#...#.....#......
#..............###.#.#.........#.#.#..#.#..#..#.#..#..#...##...#...#..........#...##...#...........#
........#..#......#..#..#...........#...##.#....#.......##.............#....#.###....#.#.......#....
...#...............#.....##.#.....#..#.#...........#..#.....#......##..###.....#.....#...#...#####..
...#..#...#...#....#..#..#.......#..##...#...###......#...#......#.#.#.##...#.......#...###..#.##...
..#....#....#.#......#.#.#..##.......#...###..#...###..#......#....................##.#.......#..##.
